1111111111111
1C1000C1000C1
1010101101101
100P00000C1E1
1111111111111