1111111111111111111111111111111111
1111110C1C00000C11C00000C1C0111111
110001011101C10111101C101110100011
110P00011101110000001110111000E011
11000101C1011101111011101C10100011
11111100000C1C0C11C001C00000111111
1111111111111111111111111111111111