1111111111111111111111111111111111111
1000000000000000000000000000000000001
10C0C0CCC0CCC000CCC00C00C0C0CCC0CCC01
10C0C00C00C0C0000C00C0C0C0C0C0C0C0001
10CCC00C00C0C0000C00CCC0CC00C0C0CCC01
1000C00C00C0C0000C00C0C0C0C0C0C0C0001
1000C00C00CCC0000C00C0C0C0C0CCC0CCC01
1000000000000000000000000000000000001
1000000000000000000000000000000000001
1000000000000000000000000000000000001
100000CCC0CCC00C00CCC0C00000CCC000001
100000C000C0C0C0C00C00C0000000C000001
100P00C000CCC0CCC00C00CCC0000C000E001
100000C000C000C0C00C00C0C000000000001
100000CCC0C000C0C00C00CCC0000C0000001
1000000000000000000000000000000000001
1111111111111111111111111111111111111