1111111111111111111111111111111111
1E10000000000000000000000000000001
1P10111111111111111111111111111101
1010100000000000000000000000000101
1010101111111111111111111111110101
1010101000000000000000000000010101
1010101011111111111111111111010101
1010101010000000000000000001010101
1010101010111111111111111101010101
101010101000000000000000C101010101
1010101011111111111111111101010101
1010101000000000000000000001010101
1010101111111111111111111111010101
1010100000000000000000000000010101
1010111111111111111111111111110101
1010000000000000000000000000000101
1011111111111111111111111111111101
1000000000000000000000000000000001
1111111111111111111111111111111111